xxxxxxxxx.......
.......#x.#.....
.......#x.......
xxxxxxxxx.......
x########.......
xxxxxxxxxxxxxxxx
.######..##...##
.....#####......
......#####.....
................