xxxxxxxx........
..##..x#........
#.....x##.......
##...#x.#.##....
......xxxxxxx...
.##...####..x.##
............x...
...######...x.##
......###...xxxx
.........###...#
