xxxxxxxx........
.......x###.....
.######x..#.....
.#.....xxx#####.
.#.######x.....#
.#......#x.###.#
.######.#x.#...#
........#x.#.###
#########x......
.........xxxxxxx
